          1         2         3         4         5         6         7         8         9 
x0123456789012345678901234567890123456789012345678901234567890123456789012345678901234567890123456789
0   
1      
25  5555555     
355555555555     
4555555555555  
555555555555555555555
65555555555/              
75555555555            555555555555
85555555555                                                                                         5
95555555555         @        255555555555555555555555555555555555555555555555555555555555555555555555
05555555555j        j        {5     5555555555       555555555555555555555555555555555555555555555555
15555555555j        j     #  {55555555555555555555555555555555555555555555555555555555555555555555555
25555555555j  ^     j     #  {555/ \55555555555555555555555555555         555555555555555555555555555
35555555555j   2@         #  \55/        #         \555555555555552  555555555555555555555555555555
45555555555nl   2   jj  [2] $           ##E         555555555555555   5555555555555555555555555555555
555555555555j~~~~2~~22222222222555555555555555555555555555555555    555555555555555555555555555555555
65555555555n222555555555555555555555555      55555555555555555555555555555555555555555555555555555555
755555555555555555                      5555555555555555555555555555555555555555555555555555555555555
85555555555555555555555555555555555555555555555555555555555555555555555555555555555555555555555555555
95555555555555555555555555555555555555555555555555555555555555555555555555555555555555555555555555555
05555555555555555555555555555555555555555555555555555555555555555555555555555555555555555555555555555
15555555555555555555555555555555555555555555555555555555555555555555555555555555555555555555555555555
25555555555555555555555555555555555555555555555555555555555555555555555555555555555555555555555555555
35555555555555555555555555555555555555555555555555555555555555555555555555555555555555555555555555555
45555555555555555555555555555555555555555555555555555555555555555555555555555555555555555555555555555
55555555555555555555555555555555555555555555555555555555555555555555555555555555555555555555555555555
65555555555555555555555555555555555555555555555555555555555555555555555555555555555555555555555555555
75555555555555555555555555555555555555555555555555555555555555555555555555555555555555555555555555555
85555555555555555555555555555555555555555555555555555555555555555555555555555555555555555555555555555
95555555555555555555555555555555555555555555555555555555555555555555555555555555555555555555555555555
05555555555555555555555555555555555555555555555555555555555555555555555555555555555555555555555555555